0 12 18 0 0 0 0 0 0 0 0 0 0 0 0 0 0
12 0 0 3 3 0 0 0 0 0 0 0 0 0 0 0 0 
18 0 0 0 7 18 31 0 0 0 0 0 0 0 0 0 0
0 3 0 0 4 0 0 19 0 0 0 0 0 0 0 0 0
0 3 7 4 0 0 0 0 21 0 0 0 0 0 0 0 0								
0 0 18 0 0 0 12 0 0 3 0 0 0 0 0 0 0				
0 0 31 0 0 12 0 0 0 0 35 0 0 0 0 0 0 0				
0 0 0 19 0 0 0 0 4 0 0 7 0 0 0 0 0		
0 0 0 0 21 0 0 4 0 13 0 0 6 0 0 0 0			
0 0 0 0 0 3 0 0 13 0 0 0 0 9 0 0 0				
0 0 0 0 0 35 0 0 0 0 0 0 24 8 7 0				
0 0 0 0 0 0 0 7 0 0 0 0 5 0 0 14 0				
0 0 0 0 0 0 0 0 6 0 0 5 0 0 0 0 6				
0 0 0 0 0 0 0 0 0 9 24 0 0 0 0 0 9				
0 0 0 0 0 0 0 0 0 0 8 0 0 0 0 6 6			
0 0 0 0 0 0 0 0 0 0 7 14 0 0 6 0 0							
0 0 0 0 0 0 0 0 0 0 0 0 6 9 6 0 0